################################################################################
#              ##      ##              ##              ##                      #
#              ##      ##              ##              ##                      #
#      ##      ##      ##########      ##########      ##      ##########      #
#      ##                      ##              ##              ##              #
#      ##                      ##              ##              ##              #
#      ##########      ##########      ##      ##################      #########
#              ##                      ##      ##                              #
#              ##                      ##      ##                              #
#########      ##      ##########      ##################      ##########      #
#              ##              ##                      ##      ##              #
#              ##              ##                      ##      ##              #
#      ##################      ##########      ##########      ##      ##      #
#                      ##      ##              ##              ##      ##      #
#                      ##      ##              ##              ##      ##      #
#################      ##      ##      ##########      ##########      #########
#              ##              ##              ##              ##              #
#              ##              ##              ##              ##              #
#      ##########      ##################      ##########      ##########      #
#                      ##                      ##                      ##      #
#                      ##                      ##                      ##      #
#      ##      ##########      ##################################      ##      #
#      ##              ##                                              ##      #
#      ##              ##                                              ##      #
################################################################################