################################################################################
#                                                                              #
#      ##  ##  ##  ##  ##  ##  ##  ##  ##  ##  ##  ##  ##  ##  ##              #
#     ############################################################     ##      #
#      ##              ##      ##      ##      ##              ##     #        #
#     ###      ##      ##      ##      ##      ##      ##    #####       #     #
#      ##########      ####  ######  ######  ######  ####  ###         ##      #
#     ###      ##                                      ##    # ###    #        #
#      ##                                              ##      ##        #     #
#     #############   ####      ####  ####      ###################     ##     #
#      ##              ##      ##      ##      ##                              #
#     ###      ##      ##      ##      ##      ##                              #
#      ##########      ###    ############    ###      ####    ##########      #
#     ###      ##                                      ##              ##      #
#              ##                                      ##      ##      ##      #
#     ###########      ##      ##      ##      ##      ##      ##      ##      #
#              ##    #       #    #          #         ##      ##      ##      #
#     ###      ##         #          #     #     #     ##              ##      #
#      ##########      ##      ##      ##      ##      ##      ##########      #
#     ###      ##         #          #    #      #     ##                      #
#              ##    #       #    #          #         ##              ##      #
#     ###########      ##      ##      ##      ##      ##################      #
#                                                                              #
#                                                                              #
################################################################################