################################################################################
#                                                                              #
#                                                                              #
#      ##########      ##########      ##########      ##########      ##      #
#                                                                      ##      #
#                                                                      ##      #
#      ##      ##########      ##########      ##########      ##      ##      #
#      ##                                                      ##              #
#      ##                                                      ##              #
#      ##      ##      ##########      ##########      ##      ##      ##      #
#              ##                                      ##              ##      #
#              ##                                      ##              ##      #
#      ##      ##      ##      ##  ##  ##  ##  ##      ##      ##      ##      #
#      ##              ##                                      ##              #
#      ##              ##                                      ##              #
#      ##      ##      ##      ##########      ##########      ##      ##      #
#              ##                                                      ##      #
#              ##                                                      ##      #
#      ##      ##      ##########      ##########      ##########      ##      #
#      ##                                                                      #
#      ##                                                                      #
#      ##      ##########      ##########      ##########      ##########      #
#                                                                              #
#                                                                              #
################################################################################