################################################################################
#                         #                     ####                           #
###                       #                     ####                           #
##     ##      ##      ## #    ##             ######  ##      ##      ##      ##
#         #               #                                                    #
#               #         #                                                    #
##     ##    #   #      ## #    ##  ##  ##     #    #   ##      ##      ##     #
###                       #  #                 #                               #
#####                                         #                        #       #
#   #  ##      ##      ##      ##    # ##    ###       ##      ##              #
#                           #   # # ####   #                              #    #
#                 #              ######   #                                    #
#      ##     # #    ##        ##      ##      ##########      ##   #          #
#                 #                    #         ######             #  ##      #
#                 #                    #          ######            #          #
# ##   ##          #    ##      ##              ##     #        ##  #    ###   #
#                 #          #      #                              # #         #
#                 #                 #             #####                        #
#  #   ##    ##        ##      ##   #  ##      ##    ####      ##   #  ##      #
#                                                    ##              #         #
#                          ###      #                ##               #        #
#      ##      ##      ## ## # ##   #  ##      ##      ##      ##      ##      #
#         #     ###########         #                                   ########
#                    #######        #                                 ##########
################################################################################