################################################################################
#                                                                              #
#  #                      #                   #          #          #          #
#                  #   #               #         #                          #  #
#      ####### #                                                #########      #
#      #       #######################    ##################### #       #      #
#      #                                                                #      #
#      #     #####    ######    ######    ######    ######    #####     #      #
#      ####  #   #    #    #    #              #    #    #    #   #  ####      #
#        ##  #             #    #              #    #             #  ##        #
#   #    ##  #   #    #    #    #   ##    ##   #    #    #    #   #  ##        #
#        ##  #####    ######    #   ##    ##   #    ######    #####  ##        #
#                                                                           #  #
#        ##  #####    ######    #   ##    ##   #    ######    #####  ##        #
#     #  ##  #   #    #    #    #   ##    ##   #    #    #    #   #  ##        #
#        ##  #             #    #              #    #             #  ##        #
#      ####  #   #    #    #    #              #    #    #    #   #  ## #      #
#      #     #####    ######    ######    ######    ######    #####     #      #
#      #                                                                #      #
#      #       #######################    #######################       #      #
#      # #######                                                #########      #
#  #                            #           #                #                 #
#    #       #       #                               #                    #    #
#                                                                              #
################################################################################