################################################################################
#                                                                              #
#                                                                              #
#                                                                              #
#      #######                                                    #######      #
#      #     #########################    #########################     #      #
#      #                                                                #      #
#      ####  #####    ######    ######    ######    ######    #####  ####      #
#        ##  #   #    #    #    #              #    #    #    #   #  ##        #
#        ##  #             #    #              #    #             #  ##        #
#        ##  #   #    #    #    #   ##    ##   #    #    #    #   #  ##        #
#        ##  #####    ######    #   ##    ##   #    ######    #####  ##        #
#                                                                              #
#        ##  #####    ######    #   ##    ##   #    ######    #####  ##        #
#        ##  #   #    #    #    #   ##    ##   #    #    #    #   #  ##        #
#        ##  #             #    #              #    #             #  ##        #
#        ##  #   #    #    #    #              #    #    #    #   #  ##        #
#      ####  #####    ######    ######    ######    ######    #####  ####      #
#      #                                                                #      #
#      #     #########################    #########################     #      #
#      #######                                                    #######      #
#                                                                              #
#                                                                              #
#                                                                              #
################################################################################